                     ┌───────────────────────────┬────────────────────────────┐
                     │                           │                            │
                     │   ┌─────────┬────────     │                ─────┐      │
                     │   │         │             │   ────┬─────        │      │
                     │   │         └─────────────┘       │             │      │
                     │   │    │                                  ──────┘      │
                     │   │    ├───────────┐     ───────────┐                  │
                     │   │    │           │                │     ┌────────────┘
                     │   │    │           └────────────    │     │
                         │   ─┼──                          │     │
                         │    │       │                    │     │    ┌───────┐
                                      │      ──────────────┘     │    │       │
                     │                │                               │       │
                     │                │                               │       │
                     │   ┌────┐       ├──────────────┐    ────────────┼─      │
                     │   │    │   ────┘              │                │       │
                     │   │    │                      │       ┌─────   │       │
                     │   │    │   ────────┐     │    │       │        │       │
                     │   │    │           │     │    │       │        └─      │
                     │   │                │     │            │                │
                     │   │          │     │     │            │     ┌──────────┤
                     │   │   ────┬──┘     │     ├────────────┘     │          │
                     │           │              │                  │          │
                     │           │              │                  │          │
                     └───────────┴──────────────┴──────────────────┴──────────┘
