┌────────────────────┬───────────────────────────┬────────────────────────────┐
│                    │                           │                            │
│                    │   ┌─────────┬────────     │                ─────┐      │
│                    │   │         │             │   ────┬─────        │      │
│                    │   │         └─────────────┘       │             │      │
│                    │   │    │                                  ──────┘      │
│                    │   │    ├───────────┐     ───────────┐                  │
│                    │   │    │           │                │     ┌────────────┘
└────────────────────┘   │    │           └────────────    │     │
                         │   ─┼──                          │     │
                         │    │       │                    │     │    ┌───────┐
                                      │      ──────────────┘     │    │       │
┌────────────────────┐                │                               │       │
│                    │                │                               │       │
│                    │   ┌────┐       ├──────────────┐    ────────────┼─      │
│                    │   │    │   ────┘              │                │       │
│                    │   │    │                      │       ┌─────   │       │
│                    │   │    │   ────────┐     │    │       │        │       │
│                    │   │    │           │     │    │       │        └─      │
│                    │   │                │     │            │                │
│                    │   │          │     │     │            │     ┌──────────┤
│                    │   │   ────┬──┘     │     ├────────────┘     │          │
│                    │           │              │                  │          │
│                    │           │              │                  │          │
└────────────────────┴───────────┴──────────────┴──────────────────┴──────────┘
